0000000000
0000000000
0022222200
0021044200
0020030220
0020200020
0020032020
0020340020
0022222220
0000000000
